x x e e x
x e e m12 x
x m12 e x x
x x e e x
x x x m13 x
x x e e x
x x e m12 x
x m12 e x x
x e x x x
x m18 x x x
x e e x x
x x e e x
x x e x x
x e e x x
x e x x x
x f x x x