e c(g) x e e
e m6 x e x
x e e e x
x e d23 m7 x
x m7 r(d21,d22,c(g_12)) m6 x
x r(b19,b20) r(e,c(g)) d22 x
x m6 e r(e,b20,c(g)) x
x e b20 m7 x
x m15 x e x
e e x c(g_1) e